angel : glean
fast : staff
bored : robed
bell : cell
tail : detail
dusty : study
night : thing
Arc : car
arch : ranch
cat : Act
elbow : below
best : better
peach : CHEAP
cat : car
inch : chin
state : taste
Flow : Wolf
God : dog
false : true
are : ear
meat : team
earth : Heart
best : bets
tea : Eat
who : how
snail : nails
pairs : Paris
counts : Tucson
small : tiny
ports : sport
stick : Ticks
votes : stove
thin : film
say : stay
march : charm